"a" = (/turf/walls,/area)
"b" = (/turf/floors,/area)
"c" = (/obj/items/ball,/turf/floors,/area)
"d" = (/turf/floors/spawn,/area)

(1,1,1) = {"
aaaaaaaaaa
abbbbbbbba
abbaaabbba
abbbbbbbba
abbbcbabba
abbbdbabba
abbbbbbbba
abaabbabaa
abbbbababa
aaaaaaaaaa
"}
