"a" = (/turf/walls,/area)
"b" = (/turf/floors,/area)
"c" = (/turf/floors/spawn,/area)

(1,1,1) = {"
aaaaaaaaaa
abbbbbbbba
abbaaabbba
abbbbbbbba
abbbbbabba
abbbcbabba
abbbbbbbba
abaabbabaa
abbbbababa
aaaaaaaaaa
"}
